S-#---####-##
#-#-#-####-##
#---#-####-##
##-##-####-##
##-#--####-##
##-#-#####-##
##-#-#---#-##
##-#-#-#-#-##
##-#-#-#-#-##
##-#---#---##
##-##########
##----------E