S-##-########
#-##-########
#--#-########
##---########
##-#-########
##-#-########
---##########
##-##########
##-##########
##-##########
##-##########
##----------E