S-###########
#-###########
#--##########
##-##########
##-##########
##-##########
##-##########
##-##########
##-##########
##-##########
##-##########
##----------E